[
  {
    "code": "road_clearing",
    "tag": "road",
    "layout": [
      "###########",
      "#.........#",
      "#...e.....#",
      "#.........#",
      "#..###....#",
      "#..#@#....#",
      "#..###....#",
      "#.........#",
      "#.....e...#",
      "#.........#",
      "#########D#"
    ]
  },
  {
    "code": "ruined_hall",
    "tag": "ruin",
    "layout": [
      "###########",
      "#..e......#",
      "#.#####...#",
      "#.#...#...#",
      "#.#.@.#...#",
      "#.#...#...#",
      "#.#####...#",
      "#.....e...#",
      "#.........#",
      "#........D#",
      "###########"
    ]
  },
  {
    "code": "mountain_gate",
    "tag": "boss",
    "layout": [
      "###########",
      "#.........#",
      "#...e.....#",
      "#.........#",
      "#..#####..#",
      "#..#.@.#..#",
      "#..#####..#",
      "#.........#",
      "#.....e...#",
      "#........D#",
      "###########"
    ]
  }
]
